22;11
++++++++++++++++++++++
++ ++   ++ ++        +
E     + +   ++++++++++
++     ++  ++++ +++ ++
++    + + ++    +++  +
+       +  ++  ++  + +
+++++ + +      ++  + +
+++++ +++  S+ +  ++  +
+          + + + +  ++
+++++ +  + + +     + +
++++++++++++++++++++++