30;15
++++++++++++++++++++++++++++++
+S                           +
+                            +
+                            +
+                            +
+                            +
+                            +
+                            +
+ ++++++++++++++++++++++++++ +
+                            +
+                            +
+                            +
+                            +
+                            +
+++++++++++++++++++++++++E++++